11111111111111111111111111111111111111111111111111
50000000000000000000000000000000000000000000000004
50000000000000000000000000000000000000000000000004
50000000000000000000000000000000000000000000000004
50000000000000000000000000000000000000000000000004
50000000000000000000000000000000000000000000000004
50000000000000000000000000000000000000000000000004
50000000000000000000000000000000000000000000000004
50000000000000000000000000000000000000000000000004
50000000000000000000000000000000000000000000000004
50000000000000000000000000000000000000000000000004
50000000000000000000000000000000000000000000000004
50000000000000000000000000000000000000000000000004
50000000000000000000000000000000000000000000000004
50000000000000000000000000000000000000000000000004
50000000000000000000000000000000000000000000000004
50000000000000000000000000000000000000000000000004
50000000000000000000000000000000000000000000000004
50000000000000000000000000000000000000000000000004
50000000000000000000000000000000000000000000000004
50000000000000000000000000000000000000000000000004
50000000000000000000000000000000000000000000000004
50000000000000000000000000000000000000000000000004
50000000000000000000000000000000000000000000000004
50000000000000000000000000000000000000000000000004
50000000000000000000000000000000000000000000000004
50000000000000000000000000000000000000000000000004
50000000000000000000000000000000000000000000000004
50000000000000000000000000000000000000000000000004
50000000000000000000000000000000000000000000000004
50000000000000000000000000000000000000000000000004
50000000000000000000000000000000000004111100000001
50000000000000000000000000000000000000000000000004
50000000000000000000000000000000000000000000002224
50000000000000000000000222000000000000000000000004
50000000000000000000000000000000000000000000000004
11111111111111111111111111111111111111111111111111
